  ____           _
 |  _ \ ___  ___| |_ ___
 | |_) / _ \/ __| __/ __|
 |  __/ (_) \__ \ |_\__ \
 |_|   \___/|___/\__|___/
> These posts are mirrored from my HTTP site.


1A summary of Trustworthy Machine Learning by Bhavani Thuraisingham et al.	/summaries/trustworthy-machine-learning

1A summary of The Ten Commandments of Ethical Medical AI by Heimo Muller et al.	/summaries/the-ten-commandments-of-ethical-medical-ai

1A summary of Hidden Potential Within Video Game Consoles by Michael Mattioli et al.	/summaries/hidden-potential-within-video-game-consoles

1A summary of Whack-a-Meltdown by Daniel Genkin and Yuval Yarom	/summaries/whack-a-meltdown

1A summary of COM-PACE: Compliance Aware Cloud Application Engineering Using Blockchain by Gagangeet Singh Aujla et al.	/summaries/com-pace-compliance-aware-cloud-application-engineering-using-blockchain

1A summary of Smart Contracts In The Global South by Nir Kshetri et al.	/summaries/smart-contracts-in-the-global-south

1A summary of Supercomputing In Python With Legate by Michael Bauer et al.	/summaries/supercomputing-in-python-with-legate

1A summary of Interactive Supercomputing With Jupyter by Rollin Thomas et al.	/summaries/interactive-supercomputing-with-jupyter

1A summary of Automated Payment Terminal Testing: How to Achieve Continuous Integration for Systems that are Almost Impossible to Virtualize by Martin Gloor et al.	/summaries/automated-payment-terminal-testing-how-to-achieve-continuous-integration-for-systems-that-are-almost-impossible-to-virtualize

1A summary of Toward Fail Safety for Security Decisions by Trent Jaeger	/summaries/toward-fail-safety-for-security-decisions

1A summary of Pervasive Security and Privacy by - A Brief Reflection on Challenges and Opportunities by Florian Alt	/summaries/pervasive-security-and-privacy-a-brief-reflection-on-challenges-and-opportunities

1A summary of Economics of Artificial Intelligence in Cybersecurity by Nir Kshetri	/summaries/economics-of-artificial-intelligence-in-cybersecurity

1A summary of Sentiment Analysis and Topic Recognition in Video Transcripts by Lukas Stappen et al.	/summaries/sentiment-analysis-and-topic-recognition-in-video-transcripts

1A summary of Advances in Human Activity Recognition by Gulustan Dogan	/summaries/advances-in-human-activity-recognition

1A summary of Challenges and Opportunities for Autonomous Micro-UAVs in Precision Agriculture by Xu Liu et al.	/summaries/challenges-and-opportunities-for-autonomous-micro-uavs-in-precision-agriculture

1A summary of Efficient Computer Vision for Embedded Systems by George K. Thiruvathukal and Yung-Hsiang Lu	/summaries/efficient-computer-vision-for-embedded-systems

1A summary of The Loudest Duck by Laura Liswood	/summaries/the-loudest-duck

1A summary of On Being a Scientist: A Guide To Responsible Conduct In Research by the National Academy of Science, National Academy of Engineering and Institute of Medicine of the National Academies	/summaries/on-being-a-scientist

1A summary of ORI Introduction to the Responsible Conduct of Research by Nicholas H. Steneck	/summaries/ori-introduction-to-the-responsible-conduct-of-research

1A summary of Joint Head Pose Estimation and Face Alignment Framework Using Global and Local CNN Features by Xiang Xu and A. Kakadiaris	/summaries/joint-head-pose-estimation-and-face-alignment-framework-using-global-and-local-cnn-features

1A summary of A Convolutional Neural Network Cascade for Face Detection by Haoxiang Li et al.	/summaries/a-convolutional-neural-network-cascade-for-face-detection

1A summary of Rethinking Semantic Segmentation from a Sequence-to-Sequence Perspective with Transformers by Sixiao Zheng et al.	/summaries/rethinking-semantic-segmentation-from-a-sequence-to-sequence-perspective-with-transformers

1A summary of by SegNet: A Deep Convolutional Encoder-Decoder Architecture for Image Segmentation by Vijay Badrinarayanan et al.	/summaries/segnet-a-deep-convolutional-encoder-decoder-architecture-for-image-segmentation

1A summary of  U-Net: Convolutional Networks for Biomedical Image Segmentation by Olaf Ronneberger et al.	/summaries/u-net-convolutional-networks-for-biomedical-image-segmentation

1A summary of Fully Convolutional Networks for Semantic Segmentation by Jonathan Long et al.	/summaries/fully-convolutional-networks-for-semantic-segmentation

1A summary of Focal Loss for Dense Object Detection by Tsung-Yi Lin et al.	/summaries/focal-loss-for-dense-object-detection

1A summary of You Only Look Once: Unified, Real-Time Object Detection by Joseph Redmon et al.	/summaries/you-only-look-once-unified-real0time-object-detection

1A summary of Faster R-CNN: Towards Real-Time Object Detection with Region Proposal Networks by Shaoqing Ren et al.	/summaries/faster-r-cnn-towards-real-time-object-detection-with-region-proposal-networks

1A summary of MobileNets: Efficient Convolutional Neural Networks for Mobile Vision Applications by Andrew G. Howard et al.	/summaries/mobilenets-efficient-convolutional-neural-networks-for-mobile-vision-applications

1A summary of Deep Residual Learning for Image Recognition by Kaiming He et al.	/summaries/deep-residual-learning-for-image-recognition

1A summary of Large-Scale Image Retrieval with Attentive Deep Local Features by Hyeonwoo Noh et al.	/summaries/large-scale-image-retrieval-with-attentive-deep-local-features

1A summary of SURF: Speeded Up Robust Features by Herbert Bay et al.	/summaries/surf-speeded-up-robust-features

1A summary of Distinctive Image Features from Scale-Invariant Keypoints by David G. Lowe	/summaries/distinctive-image-features-from-scale-invariant-keypoints

1A summary of Hidden Technical Debt in Machine Learning Systems by D. Sculley et al.	/summaries/hidden-technical-debt-in-machine-learning-systems

1A summary of Fast R-CNN by Ross Girshick	/summaries/fast-r-cnn

1A summary of Rich feature hierarchies for accurate object detection and semantic segmentation by Ross Girshick et al.	/summaries/rich-feature-hierarchies-for-accurate-object-detection-and-semantic-segmentation

1A summary of The Random Subspace Method for Constructing Decision Forests by Tin Kam Ho	/summaries/the-random-subspace-method-for-constructing-decision-forests

1A summary of Deep Learning by Yann LeCun et al,	/summaries/deep-learning

1A summary of Small World with High Risks: A Study of Security Threats in the npm Ecosystem by Markus Zimmermann et al.	/summaries/small-world-with-high-risks-a-study-of-security-threats-in-the-npm-ecosystem

1A summary of "What are Weak Links in the npm Supply Chain?", by Nusrat Zahan et al.	/summaries/what-are-weak-links-in-the-npm-supply-chain

1A summary of How Developers and Managers Define and Trade Productivity for Quality by Margaret-Anne Storey et al.	/summaries/how-developers-and-managers-define-and-trade-productivity-for-quality

1A summary of Robust Real Time-Face Detection by P. Viola and M.J. Jones	/summaries/robust-real-time-face-detection

1A summary of Learning Deep Features for Discriminative Localization by Bolei Zhou et al.	/summaries/learning-deep-features-for-discriminative-localization

1A summary of How to implement SVMs by John Platt	/summaries/how-to-implement-svms

1A summary of Applying SVMs to Face Detection by Edgar Osuna	/summaries/applying-svms-to-face-detection

1A summary of Using SVMs For Text Categorization by Susan Dumais et al	/summaries/using-svms-for-text-categorization

1A summary of SVMs - A Practical Consequence of Learning Theory by Bernhard Scholkopf	/summaries/svms-a-practical-consequence-of-learning-theory

1A summary of Runnemede: An Architecture for Ubiquitous High-Performance Computing by Nicholas P. Carter et al.	/summaries/runnemede-an-architecture-for-ubiquitous-high-performance-computing

1A summary of ImageNet Classification with Deep Convolutional Neural Networks by Krizhevsky et al.	/summaries/imagenet-classification-with-deep-convolutional-neural-networks

1A summary of Very Deep Convolutional Networks for Large-Scale Image Recognition by Karen Simonyan and Andrew Zisserman	/summaries/very-deep-convolutional-networks-for-large-scale-image-recognition

1A summary of Going deeper with convolutions by Christian Szegedy et al.	/summaries/going-deeper-with-convolutions

1A summary of How to Read a Paper by S. Keshav	/summaries/how-to-read-a-paper


.
