  ____           _
 |  _ \ ___  ___| |_ ___
 | |_) / _ \/ __| __/ __|
 |  __/ (_) \__ \ |_\__ \
 |_|   \___/|___/\__|___/
> These posts are mirrored from my HTTP site.


1personal	/categories/personal

1introduction	/categories/introduction

1hello	/categories/hello

1first-post	/categories/first-post

1security	/categories/security

1identity	/categories/identity

1gpg	/categories/gpg

1git	/categories/git

1webdev	/categories/webdev

1jamstack	/categories/jamstack

1gopher	/categories/gopher

1gemini	/categories/gemini

1blog	/categories/blog

1SIGCOMM	/categories/sigcomm

1meta	/categories/meta

1ACM SIGCOMM Computer Communication Review	/categories/acm-sigcomm-computer-communication-review

1ACM SIGCOMM	/categories/acm-sigcomm

1ACM	/categories/acm

12007	/categories/2007

1machine learning architecture	/categories/machine-learning-architecture

1machine learning	/categories/machine-learning

1arXive	/categories/arxive

1ICLR	/categories/iclr

1ImageNet	/categories/imagenet

1GPU	/categories/gpu

1deep learning	/categories/deep-learning

1computer vision	/categories/computer-vision

1Communications of the ACM	/categories/communications-of-the-acm

12017	/categories/2017

1Xenon	/categories/xenon

1System-on-chip	/categories/system-on-chip

1Runtime	/categories/runtime

1Random access memory	/categories/random-access-memory

1Memory management	/categories/memory-management

1IEEE HPCA	/categories/ieee-hpca

1Hardware	/categories/hardware

1Clocks	/categories/clocks

12013	/categories/2013

1theory	/categories/theory

1learning theory	/categories/learning-theory

1text categorization	/categories/text-categorization

1SVM	/categories/svm

1applications	/categories/applications

1SVMs	/categories/svms

1ml	/categories/ml

1implementation	/categories/implementation

1IEEE Intelligent Systems	/categories/ieee-intelligent-systems

1CV	/categories/cv

1object detection	/categories/object-detection

1DL	/categories/dl

1CNN	/categories/cnn

1class activation mapping	/categories/class-activation-mapping

1cam	/categories/cam

1arxiv	/categories/arxiv

1International Journal of Computer Vision	/categories/international-journal-of-computer-vision

1human sensing	/categories/human-sensing

1face detection	/categories/face-detection

1boosting	/categories/boosting

12004	/categories/2004

1software engineering	/categories/software-engineering

1Software creation	/categories/software-creation

1Software	/categories/software

1management	/categories/management

1Weak link Signal	/categories/weak-link-signal

1Supply Chain Security	/categories/supply-chain-security

1Software Ecosystem	/categories/software-ecosystem

1npm	/categories/npm

1ICSE-SEIP	/categories/icse-seip

12022	/categories/2022

1USENIX Security Symposium	/categories/usenix-security-symposium

12019	/categories/2019

1Nature	/categories/nature

12015	/categories/2015

1stochastic discrimination	/categories/stochastic-discrimination

1Pattern recognition	/categories/pattern-recognition

1multiple-classifier system	/categories/multiple-classifier-system

1decision tree	/categories/decision-tree

1decision forest	/categories/decision-forest

1decision combination	/categories/decision-combination

1classifier combination	/categories/classifier-combination

1bootstrapping	/categories/bootstrapping

11998	/categories/1998

1summary	/categories/summary

1CVPR	/categories/cvpr

12014	/categories/2014


.
