  ____           _
 |  _ \ ___  ___| |_ ___
 | |_) / _ \/ __| __/ __|
 |  __/ (_) \__ \ |_\__ \
 |_|   \___/|___/\__|___/
> These posts are mirrored from my HTTP site.


1A summary of Where Are They Going? Clustering Event Camera Data to Detect and Track Moving Objects by Craig Laboni et al.	/summaries/where-are-they-going-clustering-event-camera-data-to-detect-and-track-moving-objects

1A summary of Sustainable and Trustworthy Edge Machine Learning by Ivona Brandic	/summaries/sustainable-and-trustworthy-edge-machine-learning

1A summary of Trustworthy Machine Learning by Bhavani Thuraisingham et al.	/summaries/trustworthy-machine-learning

1A summary of The Ten Commandments of Ethical Medical AI by Heimo Muller et al.	/summaries/the-ten-commandments-of-ethical-medical-ai

1A summary of Hidden Potential Within Video Game Consoles by Michael Mattioli et al.	/summaries/hidden-potential-within-video-game-consoles

1A summary of Whack-a-Meltdown by Daniel Genkin and Yuval Yarom	/summaries/whack-a-meltdown

1A summary of COM-PACE: Compliance Aware Cloud Application Engineering Using Blockchain by Gagangeet Singh Aujla et al.	/summaries/com-pace-compliance-aware-cloud-application-engineering-using-blockchain

1A summary of Smart Contracts In The Global South by Nir Kshetri et al.	/summaries/smart-contracts-in-the-global-south

1A summary of Supercomputing In Python With Legate by Michael Bauer et al.	/summaries/supercomputing-in-python-with-legate

1A summary of Interactive Supercomputing With Jupyter by Rollin Thomas et al.	/summaries/interactive-supercomputing-with-jupyter

1A summary of Automated Payment Terminal Testing: How to Achieve Continuous Integration for Systems that are Almost Impossible to Virtualize by Martin Gloor et al.	/summaries/automated-payment-terminal-testing-how-to-achieve-continuous-integration-for-systems-that-are-almost-impossible-to-virtualize

1A summary of Toward Fail Safety for Security Decisions by Trent Jaeger	/summaries/toward-fail-safety-for-security-decisions

1A summary of Pervasive Security and Privacy by - A Brief Reflection on Challenges and Opportunities by Florian Alt	/summaries/pervasive-security-and-privacy-a-brief-reflection-on-challenges-and-opportunities

1A summary of Economics of Artificial Intelligence in Cybersecurity by Nir Kshetri	/summaries/economics-of-artificial-intelligence-in-cybersecurity

1A summary of Sentiment Analysis and Topic Recognition in Video Transcripts by Lukas Stappen et al.	/summaries/sentiment-analysis-and-topic-recognition-in-video-transcripts

1A summary of Advances in Human Activity Recognition by Gulustan Dogan	/summaries/advances-in-human-activity-recognition

1A summary of Challenges and Opportunities for Autonomous Micro-UAVs in Precision Agriculture by Xu Liu et al.	/summaries/challenges-and-opportunities-for-autonomous-micro-uavs-in-precision-agriculture

1A summary of Efficient Computer Vision for Embedded Systems by George K. Thiruvathukal and Yung-Hsiang Lu	/summaries/efficient-computer-vision-for-embedded-systems


.
